8
20
  XXXXXXXXXXXXXXXXXX
X XXX     XXXXXXXXXX
X  XX XXX   XXXXXXXX
X  XX X   X      XXX
X  XX X XXXXX XX XXX
X  XX X XXXXX XX XXX
X       XXXXX X  XXX
XXXXXXXXXXXXXDXXXXXX